AFGHANISTAN	AF	AFG	APNIC
ALAND ISLANDS	AX	ALA	RIPE
ALBANIA	AL	ALB	RIPE
ALGERIA	DZ	DZA	AfriNIC
AMERICAN SAMOA	AS	ASM	APNIC
ANDORRA	AD	AND	RIPE
ANGOLA	AO	AGO	AfriNIC
ASIA/PACIFIC REGION	AP	APR	APNIC
ANGUILLA	AI	AIA	ARIN
ANTARCTICA	AQ	ATA	ARIN
ANTIGUA AND BARBUDA	AG	ATG	ARIN
ARGENTINA	AR	ARG	LACNIC
ARMENIA	AM	ARM	RIPE
ARUBA	AW	ABW	LACNIC
AUSTRALIA	AU	AUS	APNIC
AUSTRIA	AT	AUT	RIPE
AZERBAIJAN	AZ	AZE	RIPE
BAHAMAS	BS	BHS	ARIN
BAHRAIN	BH	BHR	RIPE
BANGLADESH	BD	BGD	APNIC
BARBADOS	BB	BRB	ARIN
BELARUS	BY	BLR	RIPE
BELGIUM	BE	BEL	RIPE
BELIZE	BZ	BLZ	LACNIC
BENIN	BJ	BEN	AfriNIC
BERMUDA	BM	BMU	ARIN
BHUTAN	BT	BTN	APNIC
BOLIVIA	BO	BOL	LACNIC
BOSNIA AND HERZEGOWINA	BA	BIH	RIPE
BOTSWANA	BW	BWA	AfriNIC
BOUVET ISLAND	BV	BVT	ARIN
BRAZIL	BR	BRA	LACNIC
BRITISH INDIAN OCEAN TERRITORY	IO	IOT	APNIC
BRUNEI DARUSSALAM	BN	BRN	APNIC
BULGARIA	BG	BGR	RIPE
BURKINA FASO	BF	BFA	AfriNIC
BURUNDI	BI	BDI	AfriNIC
CAMBODIA	KH	KHM	APNIC
CAMEROON	CM	CMR	AfriNIC
CANADA	CA	CAN	ARIN
CAPE VERDE	CV	CPV	AfriNIC
CAYMAN ISLANDS	KY	CYM	ARIN
CENTRAL AFRICAN REPUBLIC	CF	CAF	AfriNIC
CHAD	TD	TCD	AfriNIC
CHILE	CL	CHL	LACNIC
CHINA	CN	CHN	APNIC
CHRISTMAS ISLAND	CX	CXR	APNIC
COCOS (KEELING) ISLANDS	CC	CCK	APNIC
COLOMBIA	CO	COL	LACNIC
COMOROS	KM	COM	AfriNIC
CONGO	CG	COG	AfriNIC
CONGO, THE DEMOCRATIC REPUBLIC OF THE	CD	COD	AfriNIC
COOK ISLANDS	CK	COK	APNIC
COSTA RICA	CR	CRI	LACNIC
COTE D'IVOIRE	CI	CIV	AfriNIC
CROATIA (local name: Hrvatska)	HR	HRV	RIPE
CUBA	CU	CUB	LACNIC
CYPRUS	CY	CYP	RIPE
CZECH REPUBLIC	CZ	CZE	RIPE
DENMARK	DK	DNK	RIPE
DJIBOUTI	DJ	DJI	AfriNIC
DOMINICA	DM	DMA	ARIN
DOMINICAN REPUBLIC	DO	DOM	LACNIC
ECUADOR	EC	ECU	LACNIC
EGYPT	EG	EGY	AfriNIC
EL SALVADOR	SV	SLV	LACNIC
EQUATORIAL GUINEA	GQ	GNQ	AfriNIC
ERITREA	ER	ERI	AfriNIC
ESTONIA	EE	EST	RIPE
ETHIOPIA	ET	ETH	AfriNIC
EUROPEAN UNION	EU	EUR	RIPE
FALKLAND ISLANDS (MALVINAS)	FK	FLK	LACNIC
FAROE ISLANDS	FO	FRO	RIPE
FIJI	FJ	FJI	APNIC
FINLAND	FI	FIN	RIPE
FRANCE	FR	FRA	RIPE
FRANCE, METROPOLITAN	FX	FXM	RIPE
FRENCH GUIANA	GF	GUF	LACNIC
FRENCH POLYNESIA	PF	PYF	APNIC
FRENCH SOUTHERN TERRITORIES	TF	ATF	APNIC
GABON	GA	GAB	AfriNIC
GAMBIA	GM	GMB	AfriNIC
GEORGIA	GE	GEO	RIPE
GERMANY	DE	DEU	RIPE
GHANA	GH	GHA	AfriNIC
GIBRALTAR	GI	GIB	RIPE
GREECE	GR	GRC	RIPE
GREENLAND	GL	GRL	RIPE
GRENADA	GD	GRD	ARIN
GUADELOUPE	GP	GLP	ARIN
GUAM	GU	GUM	APNIC
GUATEMALA	GT	GTM	LACNIC
GUERNSEY	GG	GGY	RIPE
GUINEA	GN	GIN	AfriNIC
GUINEA-BISSAU	GW	GNB	AfriNIC
GUYANA	GY	GUY	LACNIC
HAITI	HT	HTI	LACNIC
HEARD AND MC DONALD ISLANDS	HM	HMD	ARIN
HOLY SEE (VATICAN CITY STATE)	VA	VAT	RIPE
HONDURAS	HN	HND	LACNIC
HONG KONG	HK	HKG	APNIC
HUNGARY	HU	HUN	RIPE
ICELAND	IS	ISL	RIPE
INDIA	IN	IND	APNIC
INDONESIA	ID	IDN	APNIC
IRAN (ISLAMIC REPUBLIC OF)	IR	IRN	RIPE
IRAQ	IQ	IRQ	RIPE
IRELAND	IE	IRL	RIPE
ISLE OF MAN	IM	IMN	RIPE
ISRAEL	IL	ISR	RIPE
ITALY	IT	ITA	RIPE
JAMAICA	JM	JAM	ARIN
JAPAN	JP	JPN	APNIC
JERSEY	JE	JEY	RIPE
JORDAN	JO	JOR	RIPE
KAZAKHSTAN	KZ	KAZ	RIPE
KENYA	KE	KEN	AfriNIC
KIRIBATI	KI	KIR	APNIC
KOREA, DEMOCRATIC PEOPLE'S REPUBLIC OF	KP	PRK	APNIC
KOREA, REPUBLIC OF	KR	KOR	APNIC
KUWAIT	KW	KWT	RIPE
KYRGYZSTAN	KG	KGZ	RIPE
LAO PEOPLE'S DEMOCRATIC REPUBLIC	LA	LAO	APNIC
LATVIA	LV	LVA	RIPE
LEBANON	LB	LBN	RIPE
LESOTHO	LS	LSO	AfriNIC
LIBERIA	LR	LBR	AfriNIC
LIBYAN ARAB JAMAHIRIYA	LY	LBY	AfriNIC
LIECHTENSTEIN	LI	LIE	RIPE
LITHUANIA	LT	LTU	RIPE
LUXEMBOURG	LU	LUX	RIPE
MACAO	MO	MAC	APNIC
MACEDONIA, THE FORMER YUGOSLAV REPUBLIC OF	MK	MKD	RIPE
MADAGASCAR	MG	MDG	AfriNIC
MALAWI	MW	MWI	AfriNIC
MALAYSIA	MY	MYS	APNIC
MALDIVES	MV	MDV	APNIC
MALI	ML	MLI	AfriNIC
MALTA	MT	MLT	RIPE
MARSHALL ISLANDS	MH	MHL	APNIC
MARTINIQUE	MQ	MTQ	ARIN
MAURITANIA	MR	MRT	AfriNIC
MAURITIUS	MU	MUS	AfriNIC
MAYOTTE	YT	MYT	APNIC
MEXICO	MX	MEX	LACNIC
MICRONESIA, FEDERATED STATES OF	FM	FSM	APNIC
MOLDOVA, REPUBLIC OF	MD	MDA	RIPE
MONACO	MC	MCO	RIPE
MONGOLIA	MN	MNG	APNIC
MONTENEGRO	ME	MNE	RIPE
MONTSERRAT	MS	MSR	ARIN
MOROCCO	MA	MAR	AfriNIC
MOZAMBIQUE	MZ	MOZ	AfriNIC
MYANMAR	MM	MMR	APNIC
NAMIBIA	NA	NAM	AfriNIC
NAURU	NR	NRU	APNIC
NEPAL	NP	NPL	APNIC
NETHERLANDS	NL	NLD	RIPE
NETHERLANDS ANTILLES	AN	ANT	LACNIC
NEW CALEDONIA	NC	NCL	APNIC
NEW ZEALAND	NZ	NZL	APNIC
NICARAGUA	NI	NIC	LACNIC
NIGER	NE	NER	AfriNIC
NIGERIA	NG	NGA	AfriNIC
NIUE	NU	NIU	APNIC
NORFOLK ISLAND	NF	NFK	APNIC
NORTHERN MARIANA ISLANDS	MP	MNP	APNIC
NORWAY	NO	NOR	RIPE
OMAN	OM	OMN	RIPE
PAKISTAN	PK	PAK	APNIC
PALAU	PW	PLW	APNIC
PALESTINIAN TERRITORY, OCCUPIED	PS	PSE	RIPE
PANAMA	PA	PAN	LACNIC
PAPUA NEW GUINEA	PG	PNG	APNIC
PARAGUAY	PY	PRY	LACNIC
PERU	PE	PER	LACNIC
PHILIPPINES	PH	PHL	APNIC
PITCAIRN	PN	PCN	APNIC
POLAND	PL	POL	RIPE
PORTUGAL	PT	PRT	RIPE
PUERTO RICO	PR	PRI	ARIN
QATAR	QA	QAT	RIPE
REUNION	RE	REU	APNIC
ROMANIA	RO	ROU	RIPE
RUSSIAN FEDERATION	RU	RUS	RIPE
RWANDA	RW	RWA	AfriNIC
SAINT BARTHELEMY	BL	 	ARIN
SAINT KITTS AND NEVIS	KN	KNA	ARIN
SAINT LUCIA	LC	LCA	ARIN
SAINT MARTIN	MF	 	ARIN
SAINT VINCENT AND THE GRENADINES	VC	VCT	ARIN
SAMOA	WS	WSM	APNIC
SAN MARINO	SM	SMR	RIPE
SAO TOME AND PRINCIPE	ST	STP	AfriNIC
SAUDI ARABIA	SA	SAU	RIPE
SENEGAL	SN	SEN	AfriNIC
SERBIA	RS	SRB	RIPE
SEYCHELLES	SC	SYC	AfriNIC
SIERRA LEONE	SL	SLE	AfriNIC
SINGAPORE	SG	SGP	APNIC
SLOVAKIA (Slovak Republic)	SK	SVK	RIPE
SLOVENIA	SI	SVN	RIPE
SOLOMON ISLANDS	SB	SLB	APNIC
SOMALIA	SO	SOM	AfriNIC
SOUTH AFRICA	ZA	ZAF	AfriNIC
SOUTH GEORGIA AND THE SOUTH SANDWICH ISLANDS	GS	SGS	LACNIC
SPAIN	ES	ESP	RIPE
SRI LANKA	LK	LKA	APNIC
ST. HELENA	SH	SHN	ARIN
ST. PIERRE AND MIQUELON	PM	SPM	ARIN
SUDAN	SD	SDN	AfriNIC
SURINAME	SR	SUR	LACNIC
SVALBARD AND JAN MAYEN ISLANDS	SJ	SJM	RIPE
SWAZILAND	SZ	SWZ	AfriNIC
SWEDEN	SE	SWE	RIPE
SWITZERLAND	CH	CHE	RIPE
SYRIAN ARAB REPUBLIC	SY	SYR	RIPE
TAIWAN, PROVINCE OF CHINA	TW	TWN	APNIC
TAJIKISTAN	TJ	TJK	RIPE
TANZANIA, UNITED REPUBLIC OF	TZ	TZA	AfriNIC
THAILAND	TH	THA	APNIC
TIMOR-LESTE	TL	TLS	APNIC
TOGO	TG	TGO	AfriNIC
TOKELAU	TK	TKL	APNIC
TONGA	TO	TON	APNIC
TRINIDAD AND TOBAGO	TT	TTO	LACNIC
TUNISIA	TN	TUN	AfriNIC
TURKEY	TR	TUR	RIPE
TURKMENISTAN	TM	TKM	RIPE
TURKS AND CAICOS ISLANDS	TC	TCA	ARIN
TUVALU	TV	TUV	APNIC
UGANDA	UG	UGA	AfriNIC
UKRAINE	UA	UKR	RIPE
UNITED ARAB EMIRATES	AE	ARE	RIPE
UNITED KINGDOM	GB	GBR	RIPE
UNITED STATES	US	USA	ARIN
UNITED STATES MINOR OUTLYING ISLANDS	UM	UMI	ARIN
URUGUAY	UY	URY	LACNIC
UZBEKISTAN	UZ	UZB	RIPE
VANUATU	VU	VUT	APNIC
VENEZUELA	VE	VEN	LACNIC
VIETNAM	VN	VNM	APNIC
VIRGIN ISLANDS (BRITISH)	VG	VGB	ARIN
VIRGIN ISLANDS (U.S.)	VI	VIR	ARIN
WALLIS AND FUTUNA ISLANDS	WF	WLF	APNIC
WESTERN SAHARA	EH	ESH	AfriNIC
YEMEN	YE	YEM	RIPE
ZAMBIA	ZM	ZMB	AfriNIC
ZIMBABWE	ZW	ZWE	AfriNIC
